1111111111111
100C10C00C001
10P0000011E01
1111111111111