1111111111111
1P0C0C0E0C0
1111111111111