11111111111111111
100000000000C0011
111P00000000000C1
1110000C000000E01
11111111111111111