111111111111111111111111111111
1ECCCCCCCCCCCCCCCCCCCCCCCCCCC1
1C1CC1C1CC1CCCCC1C1CC1CCCCCCC1
1C1CC1CC1C1C1C1CCC1CC1CCCCCCC1
1PCCCCCCCCCCCCCCCCCCCCCCCCCCC1
111111111111111111111111111111
